1 2 3 3 3 7 1 7 1 2
5 1 2 3 2 6 7 6 1 1
8 2 3 2 4 3 2 5 2 1
1 1 2 4 5 3 2 4 5 3
2 4 4 3 3 4 3 3 2 3
1 6 8 4 1 3 3 2 6 2
1 6 7 1 2 2 4 2 6 5
2 1 2 1 5 2 4 6 7 5
8 4 3 6 2 3 2 8 7 4
3 2 8 4 5 2 7 8 1 2
1 5 5 2 1 1 2 3 1 2
3 2 3 4 5 6 7 8 1 2