1 2 3 4 5 7 1 7 1 2
2 3 5 3 5 6 7 6 1 1
1 2 2 1 1 3 2 5 2 1
1 4 3 4 5 3 2 4 5 3
2 4 4 3 3 4 3 3 2 3
1 6 8 4 1 3 3 2 6 2
1 6 7 1 2 2 4 2 6 5
3 2 2 1 5 6 4 6 7 5
2 4 3 6 2 3 7 8 7 4
1 2 3 4 5 6 7 8 1 2